111111111111
1E0000000001
111110C00001
10P010001001
100010011001
1000000011C1
101110000101
10C111000001
111111111111